1111111111111
1E00000000001
100P010100101
1000010010101
100000000C001
1111111111111
